Akaa	08 Pirkanmaan hyvinvointialue	
Alajärvi	16 Etelä-Pohjanmaan hyvinvointialue	
Alavieska	19 Pohjois-Pohjanmaan hyvinvointialue	
Alavus	16 Etelä-Pohjanmaan hyvinvointialue	
Asikkala	09 Päijät-Hämeen hyvinvointialue	
Askola	01 Itä-Uudenmaan hyvinvointialue	
Aura	05 Varsinais-Suomen hyvinvointialue	
Brändö	91 Ahvenanmaa	
Eckerö	91 Ahvenanmaa	
Enonkoski	12 Etelä-Savon hyvinvointialue	
Enontekiö	21 Lapin hyvinvointialue	
Espoo	03 Länsi-Uudenmaan hyvinvointialue	
Eura	06 Satakunnan hyvinvointialue	
Eurajoki	06 Satakunnan hyvinvointialue	
Evijärvi	16 Etelä-Pohjanmaan hyvinvointialue	
Finström	91 Ahvenanmaa	
Forssa	07 Kanta-Hämeen hyvinvointialue	
Föglö	91 Ahvenanmaa	
Geta	91 Ahvenanmaa	
Haapajärvi	19 Pohjois-Pohjanmaan hyvinvointialue	
Haapavesi	19 Pohjois-Pohjanmaan hyvinvointialue	
Hailuoto	19 Pohjois-Pohjanmaan hyvinvointialue	
Halsua	18 Keski-Pohjanmaan hyvinvointialue	
Hamina	10 Kymenlaakson hyvinvointialue	
Hammarland	91 Ahvenanmaa	
Hankasalmi	15 Keski-Suomen hyvinvointialue	
Hanko	03 Länsi-Uudenmaan hyvinvointialue	
Harjavalta	06 Satakunnan hyvinvointialue	
Hartola	09 Päijät-Hämeen hyvinvointialue	
Hattula	07 Kanta-Hämeen hyvinvointialue	
Hausjärvi	07 Kanta-Hämeen hyvinvointialue	
Heinola	09 Päijät-Hämeen hyvinvointialue	
Heinävesi	14 Pohjois-Karjalan hyvinvointialue	
Helsinki	90 Helsingin kaupunki	
Hirvensalmi	12 Etelä-Savon hyvinvointialue	
Hollola	09 Päijät-Hämeen hyvinvointialue	
Huittinen	06 Satakunnan hyvinvointialue	
Humppila	07 Kanta-Hämeen hyvinvointialue	
Hyrynsalmi	20 Kainuun hyvinvointialue	
Hyvinkää	02 Keski-Uudenmaan hyvinvointialue	
Hämeenkyrö	08 Pirkanmaan hyvinvointialue	
Hämeenlinna	07 Kanta-Hämeen hyvinvointialue	
Ii	19 Pohjois-Pohjanmaan hyvinvointialue	
Iisalmi	13 Pohjois-Savon hyvinvointialue	
Iitti	09 Päijät-Hämeen hyvinvointialue	
Ikaalinen	08 Pirkanmaan hyvinvointialue	
Ilmajoki	16 Etelä-Pohjanmaan hyvinvointialue	
Ilomantsi	14 Pohjois-Karjalan hyvinvointialue	
Imatra	11 Etelä-Karjalan hyvinvointialue	
Inari	21 Lapin hyvinvointialue	
Inkoo	03 Länsi-Uudenmaan hyvinvointialue	
Isojoki	16 Etelä-Pohjanmaan hyvinvointialue	
Isokyrö	16 Etelä-Pohjanmaan hyvinvointialue	
Janakkala	07 Kanta-Hämeen hyvinvointialue	
Joensuu	14 Pohjois-Karjalan hyvinvointialue	
Jokioinen	07 Kanta-Hämeen hyvinvointialue	
Jomala	91 Ahvenanmaa	
Joroinen	13 Pohjois-Savon hyvinvointialue	
Joutsa	15 Keski-Suomen hyvinvointialue	
Juuka	14 Pohjois-Karjalan hyvinvointialue	
Juupajoki	08 Pirkanmaan hyvinvointialue	
Juva	12 Etelä-Savon hyvinvointialue	
Jyväskylä	15 Keski-Suomen hyvinvointialue	
Jämijärvi	06 Satakunnan hyvinvointialue	
Jämsä	15 Keski-Suomen hyvinvointialue	
Järvenpää	02 Keski-Uudenmaan hyvinvointialue	
Kaarina	05 Varsinais-Suomen hyvinvointialue	
Kaavi	13 Pohjois-Savon hyvinvointialue	
Kajaani	20 Kainuun hyvinvointialue	
Kalajoki	19 Pohjois-Pohjanmaan hyvinvointialue	
Kangasala	08 Pirkanmaan hyvinvointialue	
Kangasniemi	12 Etelä-Savon hyvinvointialue	
Kankaanpää	06 Satakunnan hyvinvointialue	
Kannonkoski	15 Keski-Suomen hyvinvointialue	
Kannus	18 Keski-Pohjanmaan hyvinvointialue	
Karijoki	16 Etelä-Pohjanmaan hyvinvointialue	
Karkkila	03 Länsi-Uudenmaan hyvinvointialue	
Karstula	15 Keski-Suomen hyvinvointialue	
Karvia	06 Satakunnan hyvinvointialue	
Kaskinen	17 Pohjanmaan hyvinvointialue	
Kauhajoki	16 Etelä-Pohjanmaan hyvinvointialue	
Kauhava	16 Etelä-Pohjanmaan hyvinvointialue	
Kauniainen	03 Länsi-Uudenmaan hyvinvointialue	
Kaustinen	18 Keski-Pohjanmaan hyvinvointialue	
Keitele	13 Pohjois-Savon hyvinvointialue	
Kemi	21 Lapin hyvinvointialue	
Kemijärvi	21 Lapin hyvinvointialue	
Keminmaa	21 Lapin hyvinvointialue	
Kemiönsaari	05 Varsinais-Suomen hyvinvointialue	
Kempele	19 Pohjois-Pohjanmaan hyvinvointialue	
Kerava	04 Vantaan ja Keravan hyvinvointialue	
Keuruu	15 Keski-Suomen hyvinvointialue	
Kihniö	08 Pirkanmaan hyvinvointialue	
Kinnula	15 Keski-Suomen hyvinvointialue	
Kirkkonummi	03 Länsi-Uudenmaan hyvinvointialue	
Kitee	14 Pohjois-Karjalan hyvinvointialue	
Kittilä	21 Lapin hyvinvointialue	
Kiuruvesi	13 Pohjois-Savon hyvinvointialue	
Kivijärvi	15 Keski-Suomen hyvinvointialue	
Kokemäki	06 Satakunnan hyvinvointialue	
Kokkola	18 Keski-Pohjanmaan hyvinvointialue	
Kolari	21 Lapin hyvinvointialue	
Konnevesi	15 Keski-Suomen hyvinvointialue	
Kontiolahti	14 Pohjois-Karjalan hyvinvointialue	
Korsnäs	17 Pohjanmaan hyvinvointialue	
Koski Tl	05 Varsinais-Suomen hyvinvointialue	
Kotka	10 Kymenlaakson hyvinvointialue	
Kouvola	10 Kymenlaakson hyvinvointialue	
Kristiinankaupunki	17 Pohjanmaan hyvinvointialue	
Kruunupyy	17 Pohjanmaan hyvinvointialue	
Kuhmo	20 Kainuun hyvinvointialue	
Kuhmoinen	08 Pirkanmaan hyvinvointialue	
Kumlinge	91 Ahvenanmaa	
Kuopio	13 Pohjois-Savon hyvinvointialue	
Kuortane	16 Etelä-Pohjanmaan hyvinvointialue	
Kurikka	16 Etelä-Pohjanmaan hyvinvointialue	
Kustavi	05 Varsinais-Suomen hyvinvointialue	
Kuusamo	19 Pohjois-Pohjanmaan hyvinvointialue	
Kyyjärvi	15 Keski-Suomen hyvinvointialue	
Kärkölä	09 Päijät-Hämeen hyvinvointialue	
Kärsämäki	19 Pohjois-Pohjanmaan hyvinvointialue	
Kökar	91 Ahvenanmaa	
Lahti	09 Päijät-Hämeen hyvinvointialue	
Laihia	17 Pohjanmaan hyvinvointialue	
Laitila	05 Varsinais-Suomen hyvinvointialue	
Lapinjärvi	01 Itä-Uudenmaan hyvinvointialue	
Lapinlahti	13 Pohjois-Savon hyvinvointialue	
Lappajärvi	16 Etelä-Pohjanmaan hyvinvointialue	
Lappeenranta	11 Etelä-Karjalan hyvinvointialue	
Lapua	16 Etelä-Pohjanmaan hyvinvointialue	
Laukaa	15 Keski-Suomen hyvinvointialue	
Lemi	11 Etelä-Karjalan hyvinvointialue	
Lemland	91 Ahvenanmaa	
Lempäälä	08 Pirkanmaan hyvinvointialue	
Leppävirta	13 Pohjois-Savon hyvinvointialue	
Lestijärvi	18 Keski-Pohjanmaan hyvinvointialue	
Lieksa	14 Pohjois-Karjalan hyvinvointialue	
Lieto	05 Varsinais-Suomen hyvinvointialue	
Liminka	19 Pohjois-Pohjanmaan hyvinvointialue	
Liperi	14 Pohjois-Karjalan hyvinvointialue	
Lohja	03 Länsi-Uudenmaan hyvinvointialue	
Loimaa	05 Varsinais-Suomen hyvinvointialue	
Loppi	07 Kanta-Hämeen hyvinvointialue	
Loviisa	01 Itä-Uudenmaan hyvinvointialue	
Luhanka	15 Keski-Suomen hyvinvointialue	
Lumijoki	19 Pohjois-Pohjanmaan hyvinvointialue	
Lumparland	91 Ahvenanmaa	
Luoto	17 Pohjanmaan hyvinvointialue	
Luumäki	11 Etelä-Karjalan hyvinvointialue	
Maalahti	17 Pohjanmaan hyvinvointialue	
Maarianhamina - Mariehamn	91 Ahvenanmaa	
Marttila	05 Varsinais-Suomen hyvinvointialue	
Masku	05 Varsinais-Suomen hyvinvointialue	
Merijärvi	19 Pohjois-Pohjanmaan hyvinvointialue	
Merikarvia	06 Satakunnan hyvinvointialue	
Miehikkälä	10 Kymenlaakson hyvinvointialue	
Mikkeli	12 Etelä-Savon hyvinvointialue	
Muhos	19 Pohjois-Pohjanmaan hyvinvointialue	
Multia	15 Keski-Suomen hyvinvointialue	
Muonio	21 Lapin hyvinvointialue	
Mustasaari	17 Pohjanmaan hyvinvointialue	
Muurame	15 Keski-Suomen hyvinvointialue	
Mynämäki	05 Varsinais-Suomen hyvinvointialue	
Myrskylä	01 Itä-Uudenmaan hyvinvointialue	
Mäntsälä	02 Keski-Uudenmaan hyvinvointialue	
Mänttä-Vilppula	08 Pirkanmaan hyvinvointialue	
Mäntyharju	12 Etelä-Savon hyvinvointialue	
Naantali	05 Varsinais-Suomen hyvinvointialue	
Nakkila	06 Satakunnan hyvinvointialue	
Nivala	19 Pohjois-Pohjanmaan hyvinvointialue	
Nokia	08 Pirkanmaan hyvinvointialue	
Nousiainen	05 Varsinais-Suomen hyvinvointialue	
Nurmes	14 Pohjois-Karjalan hyvinvointialue	
Nurmijärvi	02 Keski-Uudenmaan hyvinvointialue	
Närpiö	17 Pohjanmaan hyvinvointialue	
Orimattila	09 Päijät-Hämeen hyvinvointialue	
Oripää	05 Varsinais-Suomen hyvinvointialue	
Orivesi	08 Pirkanmaan hyvinvointialue	
Oulainen	19 Pohjois-Pohjanmaan hyvinvointialue	
Oulu	19 Pohjois-Pohjanmaan hyvinvointialue	
Outokumpu	14 Pohjois-Karjalan hyvinvointialue	
Padasjoki	09 Päijät-Hämeen hyvinvointialue	
Paimio	05 Varsinais-Suomen hyvinvointialue	
Paltamo	20 Kainuun hyvinvointialue	
Parainen	05 Varsinais-Suomen hyvinvointialue	
Parikkala	11 Etelä-Karjalan hyvinvointialue	
Parkano	08 Pirkanmaan hyvinvointialue	
Pedersören kunta	17 Pohjanmaan hyvinvointialue	
Pelkosenniemi	21 Lapin hyvinvointialue	
Pello	21 Lapin hyvinvointialue	
Perho	18 Keski-Pohjanmaan hyvinvointialue	
Pertunmaa	12 Etelä-Savon hyvinvointialue	
Petäjävesi	15 Keski-Suomen hyvinvointialue	
Pieksämäki	12 Etelä-Savon hyvinvointialue	
Pielavesi	13 Pohjois-Savon hyvinvointialue	
Pietarsaari	17 Pohjanmaan hyvinvointialue	
Pihtipudas	15 Keski-Suomen hyvinvointialue	
Pirkkala	08 Pirkanmaan hyvinvointialue	
Polvijärvi	14 Pohjois-Karjalan hyvinvointialue	
Pomarkku	06 Satakunnan hyvinvointialue	
Pori	06 Satakunnan hyvinvointialue	
Pornainen	02 Keski-Uudenmaan hyvinvointialue	
Porvoo	01 Itä-Uudenmaan hyvinvointialue	
Posio	21 Lapin hyvinvointialue	
Pudasjärvi	19 Pohjois-Pohjanmaan hyvinvointialue	
Pukkila	01 Itä-Uudenmaan hyvinvointialue	
Punkalaidun	08 Pirkanmaan hyvinvointialue	
Puolanka	20 Kainuun hyvinvointialue	
Puumala	12 Etelä-Savon hyvinvointialue	
Pyhtää	10 Kymenlaakson hyvinvointialue	
Pyhäjoki	19 Pohjois-Pohjanmaan hyvinvointialue	
Pyhäjärvi	19 Pohjois-Pohjanmaan hyvinvointialue	
Pyhäntä	19 Pohjois-Pohjanmaan hyvinvointialue	
Pyhäranta	05 Varsinais-Suomen hyvinvointialue	
Pälkäne	08 Pirkanmaan hyvinvointialue	
Pöytyä	05 Varsinais-Suomen hyvinvointialue	
Raahe	19 Pohjois-Pohjanmaan hyvinvointialue	
Raasepori	03 Länsi-Uudenmaan hyvinvointialue	
Raisio	05 Varsinais-Suomen hyvinvointialue	
Rantasalmi	12 Etelä-Savon hyvinvointialue	
Ranua	21 Lapin hyvinvointialue	
Rauma	06 Satakunnan hyvinvointialue	
Rautalampi	13 Pohjois-Savon hyvinvointialue	
Rautavaara	13 Pohjois-Savon hyvinvointialue	
Rautjärvi	11 Etelä-Karjalan hyvinvointialue	
Reisjärvi	19 Pohjois-Pohjanmaan hyvinvointialue	
Riihimäki	07 Kanta-Hämeen hyvinvointialue	
Ristijärvi	20 Kainuun hyvinvointialue	
Rovaniemi	21 Lapin hyvinvointialue	
Ruokolahti	11 Etelä-Karjalan hyvinvointialue	
Ruovesi	08 Pirkanmaan hyvinvointialue	
Rusko	05 Varsinais-Suomen hyvinvointialue	
Rääkkylä	14 Pohjois-Karjalan hyvinvointialue	
Saarijärvi	15 Keski-Suomen hyvinvointialue	
Salla	21 Lapin hyvinvointialue	
Salo	05 Varsinais-Suomen hyvinvointialue	
Saltvik	91 Ahvenanmaa	
Sastamala	08 Pirkanmaan hyvinvointialue	
Sauvo	05 Varsinais-Suomen hyvinvointialue	
Savitaipale	11 Etelä-Karjalan hyvinvointialue	
Savonlinna	12 Etelä-Savon hyvinvointialue	
Savukoski	21 Lapin hyvinvointialue	
Seinäjoki	16 Etelä-Pohjanmaan hyvinvointialue	
Sievi	19 Pohjois-Pohjanmaan hyvinvointialue	
Siikainen	06 Satakunnan hyvinvointialue	
Siikajoki	19 Pohjois-Pohjanmaan hyvinvointialue	
Siikalatva	19 Pohjois-Pohjanmaan hyvinvointialue	
Siilinjärvi	13 Pohjois-Savon hyvinvointialue	
Simo	21 Lapin hyvinvointialue	
Sipoo	01 Itä-Uudenmaan hyvinvointialue	
Siuntio	03 Länsi-Uudenmaan hyvinvointialue	
Sodankylä	21 Lapin hyvinvointialue	
Soini	16 Etelä-Pohjanmaan hyvinvointialue	
Somero	05 Varsinais-Suomen hyvinvointialue	
Sonkajärvi	13 Pohjois-Savon hyvinvointialue	
Sotkamo	20 Kainuun hyvinvointialue	
Sottunga	91 Ahvenanmaa	
Sulkava	12 Etelä-Savon hyvinvointialue	
Sund	91 Ahvenanmaa	
Suomussalmi	20 Kainuun hyvinvointialue	
Suonenjoki	13 Pohjois-Savon hyvinvointialue	
Sysmä	09 Päijät-Hämeen hyvinvointialue	
Säkylä	06 Satakunnan hyvinvointialue	
Taipalsaari	11 Etelä-Karjalan hyvinvointialue	
Taivalkoski	19 Pohjois-Pohjanmaan hyvinvointialue	
Taivassalo	05 Varsinais-Suomen hyvinvointialue	
Tammela	07 Kanta-Hämeen hyvinvointialue	
Tampere	08 Pirkanmaan hyvinvointialue	
Tervo	13 Pohjois-Savon hyvinvointialue	
Tervola	21 Lapin hyvinvointialue	
Teuva	16 Etelä-Pohjanmaan hyvinvointialue	
Tohmajärvi	14 Pohjois-Karjalan hyvinvointialue	
Toholampi	18 Keski-Pohjanmaan hyvinvointialue	
Toivakka	15 Keski-Suomen hyvinvointialue	
Tornio	21 Lapin hyvinvointialue	
Turku	05 Varsinais-Suomen hyvinvointialue	
Tuusniemi	13 Pohjois-Savon hyvinvointialue	
Tuusula	02 Keski-Uudenmaan hyvinvointialue	
Tyrnävä	19 Pohjois-Pohjanmaan hyvinvointialue	
Ulvila	06 Satakunnan hyvinvointialue	
Urjala	08 Pirkanmaan hyvinvointialue	
Utajärvi	19 Pohjois-Pohjanmaan hyvinvointialue	
Utsjoki	21 Lapin hyvinvointialue	
Uurainen	15 Keski-Suomen hyvinvointialue	
Uusikaarlepyy	17 Pohjanmaan hyvinvointialue	
Uusikaupunki	05 Varsinais-Suomen hyvinvointialue	
Vaala	19 Pohjois-Pohjanmaan hyvinvointialue	
Vaasa	17 Pohjanmaan hyvinvointialue	
Valkeakoski	08 Pirkanmaan hyvinvointialue	
Vantaa	04 Vantaan ja Keravan hyvinvointialue	
Varkaus	13 Pohjois-Savon hyvinvointialue	
Vehmaa	05 Varsinais-Suomen hyvinvointialue	
Vesanto	13 Pohjois-Savon hyvinvointialue	
Vesilahti	08 Pirkanmaan hyvinvointialue	
Veteli	18 Keski-Pohjanmaan hyvinvointialue	
Vieremä	13 Pohjois-Savon hyvinvointialue	
Vihti	03 Länsi-Uudenmaan hyvinvointialue	
Viitasaari	15 Keski-Suomen hyvinvointialue	
Vimpeli	16 Etelä-Pohjanmaan hyvinvointialue	
Virolahti	10 Kymenlaakson hyvinvointialue	
Virrat	08 Pirkanmaan hyvinvointialue	
Vårdö	91 Ahvenanmaa	
Vöyri	17 Pohjanmaan hyvinvointialue	
Ylitornio	21 Lapin hyvinvointialue	
Ylivieska	19 Pohjois-Pohjanmaan hyvinvointialue	
Ylöjärvi	08 Pirkanmaan hyvinvointialue	
Ypäjä	07 Kanta-Hämeen hyvinvointialue	
Ähtäri	16 Etelä-Pohjanmaan hyvinvointialue	
Äänekoski	15 Keski-Suomen hyvinvointialue